0,0,0,b,b,b,b,b,b,b,b,b,b,b,b,b
0,0,0,b,t,t,0,0,t,t,t,0,0,t,t,b
0,0,0,b,t,b,0,b,t,b,t,b,0,b,t,b
0,0,0,b,i,t,t,t,t,t,i,0,0,t,i,b
0,0,0,b,0,b,0,b,t,b,t,b,i,b,i,b
0,0,0,b,t,t,t,t,i,t,t,t,t,0,t,b
0,0,0,b,t,b,t,b,t,b,t,b,t,b,i,b
0,0,0,b,i,t,t,i,t,t,t,t,t,0,t,b
0,0,0,b,t,b,0,b,i,b,0,b,0,b,0,b
0,0,0,b,t,t,0,0,t,0,i,0,0,t,t,b
0,0,0,b,b,b,b,b,b,b,b,b,b,b,b,b
