0,0,0,0,0,0,0,0,0,0,0,0,0
b,b,b,b,b,b,b,b,b,b,b,b,b
b,t,t,0,0,t,t,t,0,0,t,t,b
b,t,b,0,b,t,b,t,b,0,b,t,b
b,i,t,t,t,t,t,i,0,0,t,i,b
b,0,b,0,b,t,b,t,b,i,b,i,b
b,t,t,t,t,i,t,t,t,t,0,t,b
b,t,b,t,b,t,b,t,b,t,b,i,b
b,i,t,t,i,t,t,t,t,t,0,t,b
b,t,b,0,b,i,b,0,b,0,b,0,b
b,t,t,0,0,t,0,i,0,0,t,t,b
b,b,b,b,b,b,b,b,b,b,b,b,b
